NO ./textures/bluestone.xpm

WE ./textures/colorstone.xpm

SO ./textures/greystone.xpm

EA ./textures/redbrick.xpm

C 225,30,0
F 250,100,0

        1111111111111111111111111
        1000000000110000000000001
        1011000001110000000000001
        1001000000000000000000001
111111111011000001110000000000001
100000A0001100000111011111P101111
11110111111111011100000010001
1111011111111101 10101001A001
11000000110101011100000010001
10000000000000001100000010001
10000000000000001101010010001
11000001110101011111011110N0111
11110111 1110101 101111010001
11111111 1111111 111111111111