NO ./textures/bluestone.xpm

WE ./textures/colorstone.xpm

SO ./textures/greystone.xpm

EA ./textures/redbrick.xpm

C 225,30,0
F 250,100,0

        1111111111111111111111111
        1000000000110000000000001
        1011000001110000000000001
        1001000000000000000000001
111111111011000001110000000000001
10000000001100000111011111P101111
11110111111111011100000010001
1111011111111101 10101001AA01
11000000110101011100000010001
10000000000000001100000010001
100000000000000011010100100N1
1100000111010101111101111000111
11110111 1110101 101111010001
11111111 1111111 111111111111